1111111111111
1P00100000C01
1000001111111
100011E000001
1111111111111
