1111111111111111111111111111111111111
100000000000000C000000010000000000001
1010010100100000100001011000000010101
1010010010101010000001010000000010101
10000000PC00C000000000C100000000000C1
100000000000000C000000010000000000001
1010010100100000100001011000000010101
1010010010101010000001010000000010101
100000000C00C000000000C100000000000C1
100000000000000C000000010000000000001
100000000000000C000000010000000000001
1010010100100000100001011000000010101
1010010010101010000001010000000010101
100000000C00C000000000C100000000000C1
1000000000000000011111000000101111111
1111111111111100000001111100100001111
10100100101010000E0001010000000010101
100000000C00C000000000C100000000000C1
100000000000000C000000010000000000001
1010010100100000100001000000000010101
1010010010101010000001010000000010101
100000000C00C000000000C100000000000C1
1111111111111111111111111111111111111
