1111111111111
1P00100000C01
1000001110111
100011E0000011
1111111111111
