1111011111111
1P00100000C01
1000001110111
100011E000001
1111111111111
