1111111111111
1P00100000C01
1000001110111
105011E000001
1111111111111
